11111111111
00000000000
00000000000
00000002222
00444000133
000100000P3
00000222223
55522113333