WWWWWWWWWWWWW
W00000000000W
W0000000000SW
W00S00002222W
W00444000133W
W000100000P3W
W000S0222223W
W55522113333W
WWWWWWWWWWWWW