WWWWWWWWWWWWWWWWWWWW
W                  W
W                  W
W        4444      W
WS  444           SW
W4             4444W
W         4444     W
W    S             W
W   4444           W
W          222222  W
W        2211111   W
W    P 2211111133  W
W   22211113333335 W
W555511111333333335W
WWWWWWWWWWWWWWWWWWWW