WWWWWWWWWWWWWWWWWWWW
W       S         SW
W P     44     4444W
W222       444     W
W111               W
W111  44       444 W
W111        S      W
W111       444     W
W111               W
W111            222W
W111            111W
W333            111W
W333            333W
W333555555555555333W
WWWWWWWWWWWWWWWWWWWW