WWWWWWWWWWWWW
W           W
W          SW
W  S    2222W
W  444   133W
W         P3W
W   S 222223W
W55522113333W
WWWWWWWWWWWWW